















        ###.###
        #@....#
        #.....#
        .......
        #.....#
        #.....#
        ###.###
